11111
10P01
11001
111E1
1C011
11111