11111
10P11
11011
11101
1CE11
11111