11111111111111111111111111111
1EC00000000001C10000000000011
11000011000001C10000001100011
11000011C00001C10000001C00011
11000000000000000000001100011
1100000000000P00000000C0000C1
11111111111111111111111111111