11111111111111111111111
1E0000000000CC0011CCC01
1000000CC0011CCC0000001
10010000002000000000001
1C010001C10010001100001
10010001C12000000000001
1201C001C10011111111111
12000000000000000000001
1000000P000111111100CC1
11111111111111111111111