111111111111111
1P1CCCCCCCCCCE1
101C101C101C1C1
1C101C101C101C1
100CCCCCCCCCCC1
111111111111111