111111111111
11E1110CC111
110C1111C111
110000000C11
11P111111111
111111111111